ANG : "Netherlands Antillean Guilder"
SVC : "Salvadoran Colón"
CAD : "Canadian Dollar"
XCD : "East Caribbean Dollar"
MVR : "Maldivian Rufiyaa"
HRK : "Croatian Kuna"
AUD : "Australian Dollar"
MWK : "Malawian Kwacha"
XAG : "Silver (troy ounce)"
MAD : "Moroccan Dirham"
PHP : "Philippine Peso"
NAD : "Namibian Dollar"
GNF : "Guinean Franc"
KES : "Kenyan Shilling"
MZN : "Mozambican Metical"
BTN : "Bhutanese Ngultrum"
MGA : "Malagasy Ariary"
AZN : "Azerbaijani Manat"
XAU : "Gold (troy ounce)"
RON : "Romanian Leu"
CHF : "Swiss Franc"
EGP : "Egyptian Pound"
BSD : "Bahamian Dollar"
TWD : "New Taiwan Dollar"
GGP : "Guernsey Pound"
LVL : "Latvian Lats"
MMK : "Myanma Kyat"
WST : "Samoan Tala"
ILS : "Israeli New Sheqel"
BHD : "Bahraini Dinar"
GBP : "British Pound Sterling"
TZS : "Tanzanian Shilling"
SDG : "Sudanese Pound"
LAK : "Laotian Kip"
DJF : "Djiboutian Franc"
BYN : "New Belarusian Ruble"
MRO : "Mauritanian Ouguiya"
RWF : "Rwandan Franc"
PEN : "Peruvian Nuevo Sol"
EUR : "Euro"
ZMK : "Zambian Kwacha (pre-2013)"
RSD : "Serbian Dinar"
INR : "Indian Rupee"
MUR : "Mauritian Rupee"
BWP : "Botswanan Pula"
GEL : "Georgian Lari"
KMF : "Comorian Franc"
UZS : "Uzbekistan Som"
RUB : "Russian Ruble"
CUC : "Cuban Convertible Peso"
BGN : "Bulgarian Lev"
JOD : "Jordanian Dinar"
NGN : "Nigerian Naira"
BDT : "Bangladeshi Taka"
PKR : "Pakistani Rupee"
BRL : "Brazilian Real"
KZT : "Kazakhstani Tenge"
CVE : "Cape Verdean Escudo"
HNL : "Honduran Lempira"
NZD : "New Zealand Dollar"
ERN : "Eritrean Nakfa"
NPR : "Nepalese Rupee"
ZMW : "Zambian Kwacha"
FKP : "Falkland Islands Pound"
DZD : "Algerian Dinar"
JMD : "Jamaican Dollar"
CRC : "Costa Rican Colón"
GMD : "Gambian Dalasi"
PLN : "Polish Zloty"
AMD : "Armenian Dram"
BMD : "Bermudan Dollar"
BZD : "Belize Dollar"
BBD : "Barbadian Dollar"
SBD : "Solomon Islands Dollar"
IDR : "Indonesian Rupiah"
ALL : "Albanian Lek"
IQD : "Iraqi Dinar"
BIF : "Burundian Franc"
HKD : "Hong Kong Dollar"
GIP : "Gibraltar Pound"
BAM : "Bosnia-Herzegovina Convertible Mark"
LKR : "Sri Lankan Rupee"
QAR : "Qatari Rial"
SAR : "Saudi Riyal"
TOP : "Tongan Paʻanga"
SEK : "Swedish Krona"
ZAR : "South African Rand"
ARS : "Argentine Peso"
MYR : "Malaysian Ringgit"
BYR : "Belarusian Ruble"
KPW : "North Korean Won"
CZK : "Czech Republic Koruna"
STD : "São Tomé and Príncipe Dobra"
BTC : "Bitcoin"
ZWL : "Zimbabwean Dollar"
LSL : "Lesotho Loti"
COP : "Colombian Peso"
PAB : "Panamanian Balboa"
IRR : "Iranian Rial"
LTL : "Lithuanian Litas"
XPF : "CFP Franc"
OMR : "Omani Rial"
CNY : "Chinese Yuan"
XOF : "CFA Franc BCEAO"
AOA : "Angolan Kwanza"
SCR : "Seychellois Rupee"
MOP : "Macanese Pataca"
XDR : "Special Drawing Rights"
NIO : "Nicaraguan Córdoba"
ISK : "Icelandic Króna"
VND : "Vietnamese Dong"
UYU : "Uruguayan Peso"
VEF : "Venezuelan Bolívar Fuerte"
USD : "United States Dollar"
UGX : "Ugandan Shilling"
DOP : "Dominican Peso"
UAH : "Ukrainian Hryvnia"
BOB : "Bolivian Boliviano"
TTD : "Trinidad and Tobago Dollar"
NOK : "Norwegian Krone"
TND : "Tunisian Dinar"
SGD : "Singapore Dollar"
TMT : "Turkmenistani Manat"
GHS : "Ghanaian Cedi"
TJS : "Tajikistani Somoni"
KHR : "Cambodian Riel"
ETB : "Ethiopian Birr"
PGK : "Papua New Guinean Kina"
THB : "Thai Baht"
AED : "United Arab Emirates Dirham"
CLP : "Chilean Peso"
LRD : "Liberian Dollar"
SYP : "Syrian Pound"
KYD : "Cayman Islands Dollar"
SRD : "Surinamese Dollar"
CUP : "Cuban Peso"
LYD : "Libyan Dinar"
SLL : "Sierra Leonean Leone"
SHP : "Saint Helena Pound"
FJD : "Fijian Dollar"
IMP : "Manx pound"
JEP : "Jersey Pound"
PYG : "Paraguayan Guarani"
KRW : "South Korean Won"
SZL : "Swazi Lilangeni"
GYD : "Guyanaese Dollar"
MDL : "Moldovan Leu"
MXN : "Mexican Peso"
HTG : "Haitian Gourde"
JPY : "Japanese Yen"
SOS : "Somali Shilling"
MNT : "Mongolian Tugrik"
AFN : "Afghan Afghani"
GTQ : "Guatemalan Quetzal"
CLF : "Chilean Unit of Account (UF)"
KGS : "Kyrgystani Som"
TRY : "Turkish Lira"
YER : "Yemeni Rial"
HUF : "Hungarian Forint"
BND : "Brunei Dollar"
MKD : "Macedonian Denar"
AWG : "Aruban Florin"
CDF : "Congolese Franc"
LBP : "Lebanese Pound"
VUV : "Vanuatu Vatu"
XAF : "CFA Franc BEAC"
KWD : "Kuwaiti Dinar"
DKK : "Danish Krone"
